# Level Set: 1
# Level: #04
# Name: The Wall
HHHHHHHHHHHHHHHHHHHHHHHHHHH
PPPPPPPPPPPPPPPPPPPPPPPPPPP
NNNNNNNNNNNNNNNNNNNNNNNNNNN
NNNNNNNNNNNNNNNNNNNNNNNNNNN
WWWWWWWWW WWWW WWWWWWWWWWWW
WWWWWWW WWWWWWWW WWWWWWWWWW
WWWWWW WWWSSSSSWWW WWWWWWWW
WWWWWWW WWWWWWWWW WWWWWWWWW
WWWWWWWW WWWWWWW WWWWWWWWWW
NNNNNNNNNNNNNNNNNNNNNNNNNNN
PPPPPPPPPPPPPPPPPPPPPPPPPPP
NNNNNNNNNNNNNNNNNNNNNNNNNNN
NNNNNNNNNNNNNNNNNNNNNNNNNNN
NNNNNNNNNNNNNNNNNNNNNNNNNNN
SHSHSHSHSHSHSHSHSHSHSHSHSSH