HHHHHHHHHHHHHHHHHHHHHHHHH
PPPPPPPPPPPPPPPPPPPPPPPPP
NNNNNNNNNNNNNNNNNNNNNNNNN
WWWWWWWW WWWW WWWWWWWWWWW
WWWWWW WWWWWWWW WWWWWWWWW
WWWWW WWWSSSSSWWW WWWWWWW
WWWWWW WWWWWWWWW WWWWWWWW
WWWWWWW WWWWWWW WWWWWWWWW
NNNNNNNNNNNNNNNNNNNNNNNNN
SHSHSHSHSHSHSHSHSHSHSHSHS

